[console_scripts]
rrg-ar = rrg.scripts.ar_report:ar_report_ep
rrg-assemble-clients = rrg.scripts.assemble_clients_cache:assemble_clients_cache_ep
rrg-assemble-contracts = rrg.scripts.assemble_contracts_cache:assemble_contracts_cache_ep
rrg-assemble-employees = rrg.scripts.assemble_employees_cache:assemble_employees_cache_ep
rrg-backup-db = rrg.scripts.backup_db:backup_db_ep
rrg-backup-dir = rrg.scripts.backup_dir:backup_dir_ep
rrg-cache-clients = rrg.scripts.cache_clients:cache_clients_ep
rrg-cache-clients-ar = rrg.scripts.cache_clients_ar:cache_client_accounts_receivable_ep
rrg-cache-clients-checks = rrg.scripts.cache_clients_checks:cache_checks_ep
rrg-cache-clients-managers = rrg.scripts.cache_clients_managers:cache_client_managers_ep
rrg-cache-clients-memos = rrg.scripts.cache_client_memos:cache_client_memos_ep
rrg-cache-comm-items = rrg.scripts.cache_comm_items:cache_comm_items_ep
rrg-cache-comm-payments = rrg.scripts.cache_comm_payments:cache_comm_payments_ep
rrg-cache-contract-items = rrg.scripts.cache_contract_items:cache_contract_items_ep
rrg-cache-contracts = rrg.scripts.cache_contracts:cache_contracts_ep
rrg-cache-employees = rrg.scripts.cache_employees:cache_employees_ep
rrg-cache-employees-memos = rrg.scripts.cache_employee_memos:cache_employee_memos_ep
rrg-cache-employees-payments = rrg.scripts.cache_employees_payments:cache_employees_payments_ep
rrg-cache-expenses = rrg.scripts.cache_expenses:cache_expenses_ep
rrg-cache-invoices = rrg.scripts.cache_invoices:cache_invoices_ep
rrg-cache-invoices-items = rrg.scripts.cache_invoices_items:cache_invoices_items_ep
rrg-cache-invoices-payments = rrg.scripts.cache_invoices_payments:cache_invoice_payments_ep
rrg-cache-payrolls = rrg.scripts.cache_payrolls:cache_payrolls_ep
rrg-cache-sherees-invoices = rrg.scripts.cache_sherees_invoices:cache_invoices_ep
rrg-cache-sherees-invoices-items = rrg.scripts.cache_sherees_invoices_items:cache_invoices_items_ep
rrg-cache-states = rrg.scripts.cache_states:cache_states_ep
rrg-cache-vendors = rrg.scripts.cache_vendors:cache_vendors_ep
rrg-cached-contract = rrg.scripts.cached_contract:cached_contract_ep
rrg-cached-contracts = rrg.scripts.cached_contracts:cached_contracts_ep
rrg-cached-employee = rrg.scripts.cached_employee:cached_employee_ep
rrg-cached-employees = rrg.scripts.cached_employees:cached_employees_ep
rrg-comm = rrg.scripts.commissions:comm_ep
rrg-comm-monthlies = rrg.scripts.commissions_monthly_summaries:monthlies_summary_ep
rrg-comm-monthly = rrg.scripts.commissions_monthly_summary:monthly_detail_ep
rrg-create-test-db = rrg.utils:create_db
rrg-delete-old-voided-invoices = rrg.scripts.delete_old_voided_inv:delete_old_voided_invoices_ep
rrg-delete-zero-invoice-items = rrg.scripts.delete_old_zero_iitems:delete_zero_invoice_items_ep
rrg-download-last_db_backup = rrg.scripts.download_last_db_backup:download_last_db_backup_ep
rrg-edit-employee = rrg.scripts.edit_employee:edit_employee_ep
rrg-edit-open_invoice = rrg.scripts.edit_open_invoice:edit_open_invoice_ep
rrg-edit-timecard = rrg.scripts.edit_timecard:edit_timecard_ep
rrg-employees = rrg.scripts.employees:employees_ep
rrg-forget-reminder = rrg.scripts.forget_reminder:forget_numbered_reminder_ep
rrg-get-last-db-backup = rrg.scripts.get_last_backup:get_last_db_backup_ep
rrg-invoices-monthly = rrg.scripts.invoices_monthly:invoices_monthly_ep
rrg-open_invoices = rrg.scripts.open_invoices:open_invoices_ep
rrg-recover-joomla-files = rrg.scripts.recover_joomla_documents:recover_joomla_documents_ep
rrg-reminder-to-timecard = rrg.scripts.reminder_to_timecard:reminder_to_timecard_ep
rrg-reminders = rrg.scripts.reminders:reminders_ep
rrg-sheree-total-due = rrg.scripts.sheree_monies_due:monies_due_ep
rrg-sheree-total-due-full = rrg.scripts.sherees_monies_due_full_report:monies_due_ep
rrg-sherees-inv-monthlies = rrg.scripts.sheree_inv_monthly_summaries:monthlies_summary_ep
rrg-sherees-inv-monthly = rrg.scripts.sheree_inv_monthly_summary:monthly_detail_ep
rrg-sherees-invoices-items = rrg.scripts.sherees_invoices_items:invoices_items_ep
rrg-sherees-notes-db = rrg.scripts.notes_report:notes_ep
rrg-sherees-payroll = rrg.scripts.sherees_payroll:sherees_payroll_ep
rrg-timecards = rrg.scripts.timecards:timecards_ep
rrg-view-timecard = rrg.scripts.view_timecard:view_timecard_ep
rrg-void-timecard = rrg.scripts.void_timecard:void_timecard_ep
rrg-workers-comp-report = rrg.scripts.workers_comp_report:workers_comp_report_ep

