[console_scripts]
jacquard = jacquard.cli:main

[jacquard.commands]
conclude = jacquard.experiments.commands:Conclude
launch = jacquard.experiments.commands:Launch
list = jacquard.experiments.commands:ListExperiments
list-users = jacquard.directory.commands:ListUsers
load-experiment = jacquard.experiments.commands:Load
override = jacquard.users.commands:Override
rollout = jacquard.buckets.commands:Rollout
runserver = jacquard.service.commands:RunServer
set-default = jacquard.users.commands:SetDefault
show = jacquard.users.commands:Show
storage-dump = jacquard.storage.commands:StorageDump
storage-export = jacquard.storage.commands:StorageExport
storage-flush = jacquard.storage.commands:StorageFlush
storage-import = jacquard.storage.commands:StorageImport

[jacquard.directory_engines]
django = jacquard.directory.django:DjangoDirectory
dummy = jacquard.directory.dummy:DummyDirectory

[jacquard.http_endpoints]
experiment = jacquard.service.endpoints:ExperimentDetail
experiments-overview = jacquard.service.endpoints:ExperimentsOverview
root = jacquard.service.endpoints:Root
user = jacquard.service.endpoints:User

[jacquard.storage_engines]
dummy = jacquard.storage.dummy:DummyStore
file = jacquard.storage.file:FileStore
redis = jacquard.storage.redis:RedisStore
redis-cloned = jacquard.storage.cloned_redis:ClonedRedisStore

